11111111111111111111111111
10100000000001000001000011
100P010000000C0010000011E1
11111111111111111111111111