11111111111111111111111111
10111000011C11000001000001
101010000P00CE101000000101
11111111111111111111111111
